11111111111111111111
11000000000000000011
10000000000000000001
10000000000000000001
10000000000000000001
10000000000000000001
10000000000000000001
10000000000000000001
10000000000000000001
10000000000002220001
11000000000000000011
11111111111111111111
3
2
2
5
4
11
6


