11111111111111111111
10000000011000000001
10110000000000001101
10000000000000000001
10000000000000000001
10010000000000001001
10000000000000000001
10000000222200000001
10000000233200000001
10110000233200000001
11110001222210001101
11111111111111111111
12
8
1
11
1
2
1
3
1
1
9
13
10
9
10
10
10
18
2
5
10
18
9
18
10

