11111111111111111111
11100000011000000111
11000000011000000011
10000000011000000001
10000000011000000001
10000000011000000001
10000000222200000001
10000000022000000001
10000000000000000001
11000000000000000011
11100000000000000111
11111111111111111111
6
2
3
2
5
4
9
5
9
13
8
17
9


