11111111111111111111
11111111111111111111
11111111111111111111
11000000001000000011
10000010201000000001
10000012220000000001
10000010200000000001
10000010000000000001
11000011110000000011
11111111111111111111
11111111111111111111
11111111111111111111
5
8
5
5
3
9
4
9
7
12
5

