11111111111111111111
11000100000000100011
11000130000003100011
11000300000000000011
11000000000000000011
11000000000000000011
11000000000000000011
11000000000000000011
11000000000000000011
11020002000000000011
11122222000000000111
11111111111111111111
7
16
10
5
4
4
1
6
1
13
1
15
1
14
5

