11111111111111111111
11111000111032111111
11111000101032111111
11111000101032111111
11110000303002221111
11000000000000000011
11000000000000000011
11000000000000000011
11003000000011100011
11110000000000001111
11111000000000011111
11111111111111111111
6
9
2
9
5
11
1
5
1
3
8
13
10

