11111111111111111111
11100000000000000111
11100000000000000111
11000003111130000011
11000000122100000011
11000000122100000011
11030003222230003011
11100000000000000111
11100000000000000111
11100000000000000111
11100000111100000111
11111111111111111111
8
3
1
4
1
2
3
3
7
17
3
16
7
7
4
12
4

