11111111111111111111
11220221100110000011
12200022130100000001
10000000100100000001
10000000103100000001
10000000100100000001
10000000300300000001
10000000000000030001
10000000000000000001
11100011000011000111
11110111000011101111
11111111111111111111
8
9
1
13
1
3
9
9
6
10
5
12
6
14
9
16
9

