11111111111111111111
10100030011010000301
10000000011000000001
13000000011003000001
10000000011000000001
10030030011300003001
10000000011000000001
10030000011003000001
10000012011000001201
10000012211000001221
13000012011300001201
11111111111111111111
8
1
1
11
1
3
1
14
1
2
10
13
10
5
5
18
5
8
3
16
3

