11111111111111111111
10000000000000000031
13000000030000000001
10000000022000000001
10000002021000300001
11100000022001100001
11100000000000000001
11111000003000000001
10010000000000000001
10000000000000000011
10300000000003000111
11111111111111111111
6
10
2
12
2
3
4
13
4
4
8
16
8
